*******************************
*                             *
*************************** * *
*G*                       * * *
* *                       * * *
* *                       * * *
* *                       * * *
* ************************* * *
*                           * *
***************************** *
*                             *
*S*****************************